









R 1800 1080

NO ./brick.XPM


SO ./dio6.XPM


WE ./path_to_the_west_texture

EA ./path_to_the_east_texture


S ./path_to_the_sprite_texture


F 120,120,120


C 255,0,255


1111111111111111111111111111
1000000000000000000000000001
1000000000000000000000000001
1000000000000100000000000001
1000000000000000000000000001
1000000000000000000000000001
1000000000000100000000000001
1000000000000100000000000001
1000000000000100000000000001
1000000000000000000000000101
1000000000000000000N00000001
1000000000000000000000000001
1000000000000000000000000001
1111111111111111111111111111