









R 1800 1080

NO ./brick.XPM


SO ./dio6.XPM


WE ./wood.XPM

EA ./triforce.XPM


S ./barrel.XPM


F 120,120,120


C 255,0,255


1111111111111111111111111111
1000000000000000000000000001
1000000000000000000000000001
1000000000000100000000000001
1000000000000000000000000001
1000000000000000000000000001
1000000000111111111111111111
1000000002000000000000000001
1000000002000000000000000001
1000000002000000000000000101
1000000000200010000000200001
1000000021000000000200000001
10000N0000000000000000000001
1111111111111111111111111111